...............................................................
...............................................................
...............................................................
...............................................................
...............................................................
T.............................................................T
W.............................................................W
W.............................................................W
W....T.......T............T.......T............T.......T......W
VX...V...I.B.V.B.D..VVX...V...I.B.V.B.D..VVX...V...I.B.V.B.D..V
GGGGGGGGGGGGGGGGGGGGGGGGGGGGGGGGGGGGGGGGGGGGGGGGGGGGGGGGGGGGGGG
....................WW.........................................
....................WW.........................................
....................WW.........................................
....................WW.........................................
....................WW.........................................
T...................WW...................TT...................T
W...................WW...................WW...................W
W...................WW...................WW...................W
W....T.......T......WW....T.......T......WW....T.......T......W
VX...V...I.B.V.B.D..VVX...V...I.B.V.B.D..VVX...V...I.B.V.B.D..V
GGGGGGGGGGGGGGGGGGGGGGGGGGGGGGGGGGGGGGGGGGGGGGGGGGGGGGGGGGGGGGG
