T..................T
W..................W
W..................W
W...T.......T......W
VX..V...I.B.V.B.D..V
GGGGGGGGGGGGGGGGGGGG
....................