.W.................
.W...WWWWWWWWWWWWW.
W.W.W.............W
W..W..............W
W................BW
W...............BBW
W.WWW....D......WW.
W.W.W....W..WWWWW..
W.W.W....W..W......
W.W.WBB.WW..W......
WDW.WWWWWW.WW......
WWW.WW...WWW.......
