.WWW.............WWWW
.W..WWWWWWWWWWWWW...W
WW..................W
WX..................W
WW..................W
.W................BBW
.WBB........W..B..WWW
.WBBB.......WDBBB.W..
.WBBBB......WWWWW.W..
.WWWWW....WWW...WWW..
.....W...BW..........
.....WW.WWW..........
......WWW............