.....................
.....................
.....................
.....................
.....................
T...................T
W...................W
W...................W
W...................W
V.X...........BB.D..V
GGGGGGGGGGGGGGGGGGGGG
