TGGGGGGGGGGGGGGGGGGGT
W...................W
W...................W
W...................W
W...................W
W...................W
W...................W
W....C..............W
W....T.......T......W
VX...V...I.B.V.B.D..V
GGGGGGGGGGGGGGGGQGGGG