.....................
.....................
.....................
.....................
.....................
T...................T
W...................W
W...................W
W...................W
V.D..........BBB..X.V
GGGGGGGGGGGGGGGGGGGGG
