.W.................
.W...WWWWWWWWWWWWW.
W.W.W.............W
W..W..............W
W................BW
W...............BBW
W.WWW....D......WW.
W.W.W....W..WWWWW..
W.W.WX...W..W......
W.W.WBB.WW..W......
W.W.WWWWWW.WW......
WWW.WW...WWW.......
