.....WWW....WWWWWWWWW.
.WWWW...WWWW.........W
W....................W
W....................W
W....................W
W.....W..............W
W.....W..............W
W.....WBBBB..........W
WX...WWWWWWWD........W
WW.WWW.....WW.W.....BW
.W.W........W.WW...BBW
.W.W........W.WW..BBBW
.WWW........W.WWWWWWWW
............WWW.......
