T..................T
W..................W
W..................W
W..................W
VX..............D..V
GGGGGGGGGGGGGGGGGGGG
....................
