..................W.....
.................W.W....
.......W........W...W...
......W.W......W.....W..
...WWW...W....W.......W.
..W.......W..W.........W
.W.........WW..........W
.W....................BW
.W...................BBW
.W...............D...WWW
WW....W..........W...W..
WX....W.B........WWWWW..
WWWWW.W.B...B..WWW......
....W.W.B.W.WB.W........
....W.WWWWWWWWWW........
....WWW.................
