.W.................
.W...WWWWWWWWWWWWW.
W.W.W.............W
W..W..............W
W................BW
W.X.............BBW
W.WWW....D......WW.
W.W.W....W..WWWWW..
W.W.W....W..W......
W.W.WBB.WW..W......
W.W.WWWWWW.WW......
WWW.WW...WWW.......
