.W....WW.......WW....
.W...............W...
WW................W..
W..................W.
WW..................W
.W..........W..B....W
.W......X...WB.BBD..W
.WWWWW..WWWWWWWWWWWWW
.....W..BW...........
.....WWWWW...........
