........WWW.........
.......W...W........
......W.....W..WWWWW
.....W.......WW....W
....W.....B........W
...W......BB......BW
..W.......WWW....BBW
.W............D.WWWW
W.............B....W
WX...........WWW...W
WW....WW...W......BW
.W....WWB..WW...WWWW
.W....WWWWWWW..WW...
.WWW..W.....W.WW....
...W.WW.....WWW.....
...WWW..............