.WWW.......WWWW...WWWWWWW..
W...W.....W....W.W.......W.
W....W...W.....WW.........W
WB....WWW....W.W.....WWW..W
WBB.........WW......WW.W..W
WWWW.......WW..........WX.W
...WW............WW....WW.W
..W....B.W......W..W......W
..W....BW.W....W...W......W
.W...WWW...W....W..W.....BW
.W......W.W......WW.....BBW
W........W...........WWWWWW
W............B............W
W....B......WWW..........BW
W...WWW.................BBW
W........B.......B..D..BBBW
WWWWWWWWWWWWWWWWWWWWWWWWWWW