..W...WWWWW...WW...WWW..
.W.W.W.....W.W..W.W...W.
.W..WW......WW...WW....W
.W...W.......W....W....W
.W....................BW
.W....................BW
WW...................BBW
WX...B...............WWW
WW...W.B.....W....WW.W..
.WW..W.B....WW.B.DWWWW..
..W..W.BBB..WW.BBBW.....
..W..WWWWWW.WWWWWWW.....
..WW.W....WWW...........
...WWW..................